.EFFACE.TOUT=[0 [Efface tout le contenu de l'interpréteur. NB: les résultats peuvent être imprévisibles suivant l'état de l'interpréteur]]
.SUP.PROCS=[1 [Supprime la procédure ou la liste de procédures indiquées. NB: les résultats peuvent être imprévisibles suivant l'état de l'interpréteur]]
.SUP.VARS=[1 [Supprime la variable ou la liste de variables indiquées. NB: les résultats peuvent être imprévisibles suivant l'état de l'interpréteur]]
ABS=[1 [Renvoie la valeur absolue du nombre fourni en paramètre]]
ABSOLUE=[1 [Renvoie la valeur absolue du nombre fourni en paramètre]]
ANNULE=[1 [Supprime la liste de propriétés fournie en paramètre]]
ANPROP=[2 [Supprime de la liste de propriétés (premier paramètre) la propriété indiquée (second paramètre)]]
APPARTIENT.A=[1 [Renvoie le nom du paquet auquel appartient l’objet indiqué en paramètre ou le mot vide.]]
ARCCOS=[1 [Renvoie en degrés l'arccosinus du paramètre]]
ARCCOSINUS=[1 [Renvoie en degrés l'arccosinus du paramètre]]
ARCSIN=[1 [Renvoie en degrés l'arcsinus du paramètre]]
ARCSINUS=[1 [Renvoie en degrés l'arcsinus du paramètre]]
ARRONDI=[1 [Renvoie la valeur arrondie du nombre fourni en paramètres]]
AU.CARRE=[1 [Renvoie le carré du nombre fourni en paramètre]]
AV=[1 [La tortue avance du nombre de pas fourni en paramètres]]
AVANCE=[1 [La tortue avance du nombre de pas fourni en paramètres]]
BAISSE.CRAYON=[0 [Le crayon de la tortue est baissé et laisse donc une trace lors de ses déplacements]]
BAISSE?=[0 [Indique si le crayon de la tortue est baissé]]
BC=[0[Le crayon de la tortue est baissé et laisse donc une trace lors de ses déplacements]]
BOUCLE=[4 [Répète l'exécution de la liste fournie en quatrième paramètre à partir d'une variable (premier paramètre) qui balaiera les valeurs entières comprises entre les paramètres entiers deux et trois]]
CACHE.TORTUE=[0 [La tortue devient invisible]]
CAP=[0 [Renvoie la direction des déplacements de la tortue]]
CC=[0 [Renvoie la couleur du crayon de la tortue]]
CF=[0 [Renvoie la couleur du fond de l'écran de la tortue]]
CHARGE=[1 [Charge le fichier fourni en paramètre]]
CHARGE.PROCS=[1 [Charge le fichier de procédures fourni en paramètre]]
CHARGE.VARS=[1 [Charge le fichier de variables fourni en paramètre]]]
CHOSE=[1 [Renvoie la valeur associée à une variable]]
CLOS=[0 [L'écran de la tortue est limité à l'écran visible]
COMPTE=[1 [Renvoie le nombre d'éléments de l'objet fourni en paramètre]]
COMPTE.PROPS=[1 [Renvoie le nombre de propriétés associées à l'objet fourni en paramètre]]
CONFIRMEED=[1 [Affiche une boîte de dialogue pour la confirmation d'une opération]]
COPIE.PROC=[2 [Copie la définition de la procédure (premier paramètre) vers une nouvelle procédure (second paramètre)]]
COS=[1 [Renvoie le cosinus du nombre fourni en paramètre (en degrés)]]
COSINUS=[1 [Renvoie le cosinus du nombre fourni en paramètre (en degrés)]]
COTAN=[1 [Renvoie la cotangente du nombre fourni en paramètre (en degrés)]]
COTANGENTE=[1 [Renvoie la cotangente du nombre fourni en paramètre (en degrés)]]
COULEUR.CRAYON=[0 [Renvoie la couleur du crayon de la tortue]]
COULEUR.FOND=[0 [Renvoie la couleur du fond de l'écran de la tortue]]
COULEUR.FOND.TEXTE=[0 [Renvoie la couleur du fond de l'écran de texte]]
COULEUR.TEXTE=[0 [Renvoie la couleur d'écriture du texte]]
CT=[0 [La tortue devient invisible]]
DEF.PROC=[1 [Renvoie la définition de la procédure dont le nom a été fourni en paramètre]]
DEPAQUETTE=[1 [L'objet dont le nom est fourni en paramètre est sorti du paquet auquel il appartient]]
DER=[1 [Renvoie le dernier élément de l'objet fourni en paramètre]]
DERNIER=[1 [Renvoie le dernier élément de l'objet fourni en paramètre]]
DETERRE=[1 [Rend modifiables les éléments du paquet dont le nom est fourni en paramètre]]
DIFF=[2 [Renvoie la différence des deux nombres fournis en paramètres]]
DIFFERENCE=[2 [Renvoie la différence des deux nombres fournis en paramètres]]
DISTANCE=[1 [Renvoie la distance qui sépare la tortue du point dont les coordonnées ont été fournies en paramètre sous forme de liste]]
DIV=[2 [Renvoie le quotient des deux nombres fournis en paramètres]]
DONNE=[2 [Fixe la valeur (second paramètre) de la variable dont le nom est fourni par le premier paramètre]]
DPROP=[3 [Crée ou met à jour la propriété de la liste de propriétés fournie en paramètre]]
DROITE=[1 [La tortue tourne à droite des degrés indiqués par le paramètre fourni]]
EC=[1 [Ecrit sur l'écran de texte ce qui est fourni en paramètre sans afficher les caractères d'échappement]]
ECHELLE=[0 [la liste renvoyée contient un premier entier qui indique l’échelle des déplacements de la tortue selon l’axe des abscisses et un second entier qui indique l’échelle selon l’axe des ordonnées]]
ECRIS=[1 [Ecrit sur l'écran de texte ce qui est fourni en paramètre sans afficher les caractères d'échappement]]
ECRIST=[1 [Ecrit sur l'écran de texte ce qui est fourni en paramètre en affichant les caractères d'échappement]]
EDITE.PAQUET=[1 [Envoie vers l'éditeur l'ensemble des objets appartenant au paquet indiqué par le paramètre]]
EDITE.PROC=[1 [Renvoie la définition de la procédure fournie en paramètre vers l'éditeur]]
EDITE.TOUT=[0 [Renvoie tout le contenu du noyau vers l'éditeur]]
EGAL?=[2 [Indique si les deux objets fournis en paramètres sont égaux]]
ELEMENT=[2 [Renvoie l'élément de l'objet fourni par le second paramètre portant le numéro fourni par le premier paramètre]]
ELEMENTS.PAQUET=[1 [Renvoie la liste des éléments du paquet dont le nom est fourni en paramètre]]
ENROULE=[0 [Si la tortue sort de l'écran, elle réapparaît depuis le côté opposé]]
ENT=[1 [Renvoie la partie entière du nombre fourni en paramètre]]
ENTERRE=[1 [Protège le paquet dont le nom est fourni par le premier paramètre]]
ENTERRE?=[1 [Indique si l'objet fourni en paramètre est enterré]]
ENTIER=[1 [Renvoie la partie entière du nombre fourni en paramètre]]
ET=[2 [Renvoie la valeur "vrai" si les deux paramètres fournis renvoient tous les deux la valeur "vrai"]]
ETAT.CRAYON=[0 [La liste renvoyée fournit les données relatives au crayon de la tortue : sa couleur, son épaisseur, s’il écrit ou non, si l’écriture est inversée ou non]]
ETAT.ECRAN=[0 [La liste renvoyée indique l’état actuel de l’écran avec les données suivantes : couleur, hauteur et largeur]]
ETAT.TORTUE=[0 [La liste renvoyée fournit les données relatives à la tortue : son abscisse, son ordonnée, son cap, sa taille, sa vitesse, sa visibilité et si elle est figurée par un triangle]]
EXEC=[1 [Exécute la liste fournie en paramètre]]
EXECUTE=[1 [Exécute la liste fournie en paramètre]]
EXP=[1 [Renvoie l'exponentielle du nombre fourni en paramètre]]
FAUX=[0 [Renvoie la valeur FAUX (0)]]
FCAP=[1 [Fixe la direction de déplacement de la tortue à la donnée fournie par le paramètre. La direction 0 est celle indiquée par le bord droit de l'écran. Le décompte se fait dans le sens inversé des aiguilles d'une montre et en degrés]]
FCC=[1 [Détermine la couleur d’écriture du crayon de la tortue]]
FCF=[1 [Détermine la couleur de fond de l’écran de la tortue]]
FCFT=[1 [Détermine la couleur de fond du texte]]
FCT=[1 [Le texte sera écrit avec la couleur de caractère spécifiée en entrée]]
FEC=[1 [L’état du crayon est fixé selon le contenu de la liste : couleur, épaisseur, écriture ou non, inversion ou non]]
FEN=[0 [Si la tortue sort de l'écran, elle semble disparaître. C'est la valeur par défaut]]
FENETRE=[0 [Si la tortue sort de l'écran, elle semble disparaître. C'est la valeur par défaut]]
FIN=[0 [Marque la fin de la définition d'une procédure]]
FIXE.CAP=[1 [Fixe la direction de déplacement de la tortue à la donnée fournie par le paramètre. La direction 0 est celle indiquée par le bord droit de l'écran. Le décompte se fait dans le sens inversé des aiguilles d'une montre et en degrés]]
FIXE.COULEUR.CRAYON=[1 [Détermine la couleur d’écriture du crayon de la tortue]]
FIXE.COULEUR.FOND=[1 [Détermine la couleur de fond de l’écran de la tortue]]
FIXE.COULEUR.FOND.TEXTE=[1 [Détermine la couleur de fond du texte]]
FIXE.COULEUR.TEXTE=[1 [Le texte sera écrit avec la couleur de caractère spécifiée en entrée]]
FIXE.CRAYON=[1 [L’état du crayon est fixé selon le contenu de la liste fournie en entrée : couleur, épaisseur, écriture ou non, inversion ou non]]
FIXE.ECHELLE=[2 [Fixe les proportions du déplacement de la tortue. Par défaut, la valeur pour les abscisses (premier entier) et pour les ordonnées (second paramètre) est de 100. Une valeur moindre réduira les déplacements dans la proportion indiquée et une valeur supérieure l’augmentera. Par exemple, fixer le premier entier à 200 et le second à 50 fera que la tortue se déplacera deux fois plus vite horizontalement que la normale et deux fois plus lentement verticalement.]]
FIXE.ECHELLEX=[1 [Fixe la proportion du déplacement de la tortue selon l’axe des abscisses]]
FIXE.ECHELLEY=[1 [Fixe la proportion du déplacement de la tortue selon l’axe des ordonnées]]
FIXE.ECRAN=[1 [Détermine la couleur, la largeur et la hauteur de l'écran de la tortue]]
FIXE.ETAT.CRAYON=[1 [L’état du crayon est fixé selon le contenu de la liste fournie en entrée : couleur, épaisseur, écriture ou non, inversion ou non]]
FIXE.ETAT.TORTUE=[1 [L’état de la tortue est fixé selon le contenu de la liste fournie en entrée: abscisse, ordonnée, orientation, taille, vitesse, visibilité et type de tortue. La tortue dessine durant le changement si le crayon est baissé]]
FIXE.FONTE=[Fixe le nom de la fonte à utiliser pour l'écran de texte]]
FIXE.POS=[1 [La tortue est envoyée à la position indiquée par la liste fournie en entrée : le premier élément fixe l’abscisse tandis que le second détermine l’ordonnée]]
FIXE.TAILLE=[1 [Fixe la taille de la tortue au nombre fourni en paramètre. Ne s'applique qu'à la tortue triangulaire]]
FIXE.TAILLE.CRAYON=[1 [Fixe la taille d'écriture du crayon]]
FIXE.TAILLE.FONTE=[1 [Fixe la taille de la fonte d'écriture sur l'écran de texte]]
FIXE.TAILLE=[1 [Détremine la taille de la tortue de forme triangulaire]]
FIXE.VITESSE=[1 [Fixe la vitesse de la tortue à la valeur indiquée par le nombre fourni en paramètre.]]
FIXE.XY=[2 [Fixe les coordonnées de la tortue (abscisse et ordonnée) en fonction des deux paramètres fournis en entrée]]
FIXEX=[1 [Fixe l'abscisse de la tortue]]
FIXEY=[1 [Fixe l'ordonnée de la tortue]]
FONTE=[0 [Renvoie le nom de la fonte utilisée pour l'écran de texte]]
FPOS=[1 [La tortue est envoyée à la position indiquée par la liste : le premier élément fixe l’abscisse tandis que le second détermine l’ordonnée]]
FRAC=[1 [Renvoie la partie fractionnaire du nombre fourni en paramètre]]
FTF=[1 [Fixe la taille de la fonte d'écriture sur l'écran de texte]]
FX=[1 [Fixe l'abscisse de la tortue]]
FXY=[2 [Fixe les coordonnées de la tortue (abscisse et ordonnée) en fonction des deux paramètres fournis en entrée]]
FY=[1 [Fixe l'ordonnée de la tortue]]
GAUCHE=[1 [La tortue tourne à gauche des degrés indiqués par le paramètre fourni]]
GOMME=[0[La tortue efface les traits en avançant]]
GRAS=[1 [Active ou désactive l'écriture en gras suivant la valeur booléenne fournie en paramètre]]
GVLOGO=[0 [Renvoie la ligne de copyright de GVLOGO]]
HASARD=[1 [Renvoie un élément de l'objet fourni en paramètre en le tirant au hasard]]
HYPOTHENUSE=[2 [Renvoie l'hypothénuse du triangle rectangle dont les côtés ont pour longueur les deux paramètres fournis en entrée]]
IDENTIFICATEUR?=[1 [Indique si le mot fourni en paramètre est un identificateur correct]]
INSERE=[3 [Renvoie l'objet (troisième paramètre) dont l'élément fourni par le premier paramètre (un nombre) esr remplacé par le deuxième paramètre]]
INVERSE=[1 [Renvoie les éléments de l'objet fourni en paramètre dans l'ordre inverse du départ]]
INVERSE.CRAYON=[0 [Le crayon de la tortue écrit dans la couleur complémentaire de la couleur en cours]]
ITALIQUE=[1 [Active ou désactive l'écriture en italiques suivant la valeur booléenne fournie en paramètre]]
ITEM=[2 [Renvoie l'élément de l'objet fourni par le second paramètre portant le numéro fourni par le premier paramètre]]
LC=[0 [Le crayon de la tortue est levé et ne laisse donc pas de trace lors de ses déplacements]]
LEVE.CRAYON=[0 [Le crayon de la tortue est levé et ne laisse donc pas de trace lors de ses déplacements]]
LIS.CAR=[0 [Attend la frappe d'un caractère dont la valeur est renvoyée]]
LIS.LISTE=[0 [Attend la frappe d'une liste dont la valeur est renvoyée]]
LISTE=[2 [Renvoie la liste formée des deux objets fournis en paramètres]]
LISTE.PROP?=[1 [Indique si l'objet fourni en paramètre est une liste de propriétés]]
LISTE.VERS.PAQUET=[2 [Place dans le paquet indiqué par le premier paramètre l'ensemble des objets contenus dans la liste fournie en second paramètre]]
LISTE?=[1 [Indique si l'objet fourni en entrée est une liste]]
LL=[0 [Attend la frappe d'une liste dont la valeur est renvoyée]]
LN=[1 [Renvoie le logarithme népérien du nombre fourni en paramètre]] 
LOCALE=[1 [Définit le mot fourni en paramètre en tant que variable locale]]
LOCALES=[0 [Renvoie la liste des variables locales en cours]]
LOG=[1 [Renvoie le logarithme décimal du nombre fourni en paramètre]]
LOG2=[1 [Renvoie le logarithme en base 2 du nombre fourni en paramètre]]
MAJUSCULES=[1 [Renvoie en majuscules le texte fourni en paramètre]]
MAX=[2 [Renvoie le maximum des deux données fournies en paramètres]]
MAXIMUM=[2 [Renvoie le maximum des deux données fournies en paramètres]]
MD=[2 [Renvoie l'objet composé du premier objet fourni en paramètre suivi du second objet]]
MELANGE=[1 [Mélange les éléments de l'objet fourni en paramètre]]
MEMBRE?=[2 [Indique si l'objet fourni par le premier paramètre fait partie du second]]
METS.DERNIER=[2 [Renvoie l'objet composé du premier objet fourni en paramètre suivi du second objet]]
METS.PREMIER=[2 [Renvoie l'objet composé du premier objet fourni en paramètre précédé du second objet]]
MIN=[2 [Renvoie le minimum des deux données fournies en paramètres]]
MINIMUM=[2 [Renvoie le minimum des deux données fournies en paramètres]]
MINUSCULES=[1 [Renvoie en minuscules le texte fourni en paramètre]]
MOD=[2 [Renvoie le premier entier fourni en paramètre modulo le second]]
MONTRE.TORTUE=[0 [La tortue devient visible]]
MOT=[2 [Renvoie le mot composé du premier mot fourni en paramètre suivi du second]]
MOT?=[1 [Indique si l'objet fourni en paramètre est un mot]]
MP=[2 [Renvoie l'objet composé du premier objet fourni en paramètre précédé du second objet]]
MT=[0 [La tortue devient visible]]
MUL=[2 [Renvoie le produit des deux nombres fournis en paramètres d'entrée]]
NB.PARAMS.PROC=[1 [Renvoie le nombre de paramètres de la procédure fournie en paramètre]]
NEGATIF?=[1 [Indique si le nombre fourni en entrée est positif]]
NETTOIE=[0[Vide l'écran de la tortue sans modifier cette dernière]]
NIVEAU.SUP=[0 [Remonte tous les niveaux d'imbrication des procédures récursives]]
NOM?=[1 [Indique si l'objet fourni en paramètre est une variable]]
NOMBRE?=[1 [Indique si l'objet fourni en entrée est un nombre]]
NON=[2 [Renvoie le contraire de la valeur booléennne fournie en paramètre]]
NORMAL=[0 [Le crayon n’inverse plus et n’efface plus]]
OPPOSE=[1 [Renvoie l'opposé du nombre fourni en paramètre]]
ORIGINE=[0 [La tortue est replacée à son origine]]
OU=[2 [Indique si au moins une des deux valeurs booléennes fournies en paramètres a la valeur "vrai"]]
PAQUET=[1 [Crée le paquet dont le nom sera celui fourni en paramètre]]
PAQUET.VERS.LISTE=[1 [Renvoie la liste des éléments d'un paquet]]
PARAMS.PROC=[1 [Renvoie la liste des paramètres de la procédure fournie en paramètre]]
PH=[2 [Renvoie la phrase composée des deux objets fournis en entrée]]
PHRASE=[2 [Renvoie la phrase composée des deux objets fournis en entrée]]
PHRASE.FIN=[2 [Renvoie la phrase composée des deux objets fournis en entrée, le premier paramètre étant placé après le premier]]
PI=[0 [Renvoie la valeur de PI : 3,14159...]]
PLG?=[2 [Indique si le premier objet fourni en entrée est plus grand que le second]]
PLISTE=[2 [Renvoie l'ensemble des propriétés de l'objet fourni en paramètre]]
PLP?=[2 [Indique si le premier objet fourni en entrée est plus petit que le second]]
POS=[0 [La liste renvoyée contient un premier entier qui indique l’abscisse de la tortue et un second entier qui indique son ordonnée]]
POSITIF?=[1 [Indique si le nombre fourni en paramètre est positif]]
POUR=[0 [Introduit la définition d'une nouvelle procédure]]
PRECEDENT=[2 [Renvoie l'objet parmi les deux fournis en paramètres qui vient le premier par ordre alphabétique]]
PREM=[1 [Renvoie le premier élément de l'objet fourni en paramètre]]
PREMIER=[1 [Renvoie le premier élément de l'objet fourni en paramètre]]
PREMS=[1 [Renvoie le premier élément de chacun des éléments de l'objet fourni en paramètre]]
PRIMITIVE?=[1 [Indique si l'objet fourni en paramètre est une primitive]]
PRIMITIVES=[0 [Renvoie la liste des primitives]]
PROCEDURE?=[1 [Indique si l'objet fourni en paramètre est une procédure]]
PROCEDURES=[0 [Renvoie la liste des procédures]]
PRODUIT=[2 [Renvoie le produit des deux nombres fournis en paramètres d'entrée]]
PROP?=[2 [Indique si le second paramètre est une propriété du premier paramètre]]
PROPS=[1 [Renvoie la liste des propriétés de l'objet dont le nom est fourni en paramètre]]
PROTEGE?=[1 [Indique si l'objet fourni en entrée est protégé]]
PUISSANCE=[2 [Renvoie un nombre (premier paramètre) élevé à la puissance d'un autre nombre (second paramètre)]]
QUOTIENT=[2 [Renvoie le quotient des deux nombres fournis en paramètres]]
RAC=[1 [Renvoie la racine carrée du nombre fourni en paramètre]]
RACINE=[1 [Renvoie la racine carrée du nombre fourni en paramètre]]
RE=[1 [La tortue recule du nombre de pas fourni en paramètres]]
RECULE=[1 [La tortue avance du nombre de pas fourni en paramètres]]
REMPLACE=[3 [Remplace l'élément indiqué par le premier paramètre (un nombre) par l'objet fourni en deuxième paramètre au sein de l'objet fourni en troisième paramètre]]
RENDS=[1 [Renvoie la valeur du paramètre fourni]]
REPETE=[2 [Répète x fois (premier paramètre) l'exécution de la liste fournie en second paramètre]]
ROTATION=[1 [Renvoie le contenu du paramètre qui suit en lui faisant opérer une rotation]]
RPROP=[2 [Renvoie la valeur de la propriété (second paramètre) de l'objet fourni en premier paramètre]]
SAUF.DERNIER=[1 [Renvoie l'objet fourni en entrée sans son dernier élément]]
SAUF.PREMIER=[1 [Renvoie l'objet fourni en entrée sans son premier élément]]
SAUF.PREMS[1 [Renvoie tout sauf le premier élément de chacun des éléments de l'objet fourni en paramètre]]
SAUVE=[1 [Sauvegarde l'espace de travail dans le fichier dont le nom est spécifié en paramètre]]
SAUVE.PAQUET=[1 [Sauve les objets du paquet indiqué en paramètre dans un fichier qui portera le nom de ce paquet]]
SAUVE.PROCS=[1 [Enregistre la définition des procédures définies dans le fichier dont le nom sera celui fourni par l'unique paramètre]]
SAUVE.VARS=[1 [Enregistre la définition des variables définies dans le fichier dont le nom sera celui fourni par l'unique paramètre]]
SD=[1 [Renvoie l'objet fourni en entrée sans son dernier élément]]
SI=[2 [Si le premier paramètre rend la valeur "vrai", exécute la liste qui suit]]
SI.FAUX=[1 [La liste fournie en paramètre est exécutée si la primitive TESTE a rendu la valeur "faux"]]
SI.VRAI=[1 [La liste fournie en paramètre est exécutée si la primitive TESTE a rendu la valeur "vrai"]]
SIGNE=[1 [Renvoie -1 si le nombre fourni en paramètre est négatif, 0 s'il est nul et 1 s'il est positif]]
SIN=[1 [Renvoie le sinus du nombre fourni en paramètre (en degrés)]]
SINON=[1 [La liste qui suit est exécutée si un SI a rendu la valeur "faux"]]
SINUS=[1 [Renvoie le sinus du nombre fourni en paramètre (en degrés)]]
SOMME=[2 [Renvoie la somme des deux nombres fournis en paramètres]]
SORTIE.TORTUE=[0 [Envoie vers la tortue ou vers l'écran de texte les futures écritures, suivant la valeur booléenne fournie en paramètre :la valeur "vrai" correspond à l'envoi vers la tortue ]]
SOULIGNE=[1 [Souligne ou non le texte qui sera écrit, suivant la valeur booléenne qui est fournie en paramètre]]
SP=[1 [Renvoie l'objet fourni en entrée sans son premier élément]]
STOP=[0 [Arrête la procédure en cours]]
SUIVANT=[2 [Renvoie l'objet parmi les deux fournis en paramètres qui vient après par ordre alphabétique]]
SUPPRIME=[2 [Supprime l'élément indiqué par le premier paramètre (un nombre) de l'objet fourni en second paramètre]]
SUPPRIME.PAQUET=[1 [Supprime le paquet indiqué en paramètre]]
TAILLE=[0 [Renvoie la taille de la tortue de forme triangulaire]]
TAILLE.CRAYON=[0 [Renvoie la taille d'écriture du crayon de la tortue]]
TAILLE.FONTE=[0 [Renvoie la taille de la fonte actuelle]]
TAN=[1 [Renvoie la tangente du nombre fourni en paramètre (en degrés)]]
TANGENTE=[1 [Renvoie la tangente du nombre fourni en paramètre (en degrés)]]
TAPE=[1 [Ecris le texte fourni en paramètre, mais sans retour à la ligne]]
TD=[1 [La tortue tourne à droite des degrés indiqués par le paramètre fourni]]
TESTE=[1 [Teste le paramètre fourni et stocke sa valeur booléenne. Prépare ainsi SI.VRAI et SI.FAUX]]
TF=[0 [Renvoie la taille de la fonte actuelle]]
TG=[1 [La tortue tourne à gauche des degrés indiqués par le paramètre fourni]]
TORTUE.DESSIN=[0 [La tortue est représentée par un dessin]]
TORTUE.NORMALE=[0 [La tortue est représentée par un triangle]]
TRACE=[0 [Active ou désactive la trace d'exécution du programme en cours]]
TRIE=[1 [Renvoie l'objet fourni en entrée sous sa forme triée]]
TRONQUE=[1 [Renvoie le nombre fourni en paramètre privé de sa partie décimale]]
VALEUR.CRAYON=[0 [Renvoie la liste des valeurs associées au crayon de la tortue]]
VALEUR.ECRAN=[0 [Renvoie la liste des valeurs associées à l'écran de la tortue]]
VALEUR.TORTUE=[0 [Renvoie la liste des valeurs associées à la tortue]]
VARIABLES=[0 [Renvoie la liste des variables]]
VE=[0 [Vide l'écran de la tortue]]
VERS=[2 [L’entier renvoyé indique le cap que devrait avoir la tortue pour pointer vers le point dont les coordonnées sont fournies en entrée]]
VERS.PAQUET=[2 [Place l'objet fourni par le second paramètre dans le paquet indiqué par le premier]]
VIDE.ECRAN=[0 [Vide l'écran de la tortue]]
VIDE.TEXTE=[0 [Vide l'écran du texte]]
VIDE?=[1 [Indique si l'objet fourni en paramètre est vide]]
VISIBLE?=[0 [Indique si la tortue est visible]]
VITESSE=[0 [Renvoie la vitesse de la tortue]]
VRAI=[0 [Renvoie la valeur VRAI (-1)]]
VT=[0 [Vide l'écran du texte]]
XCOOR=[0 [Renvoie l'abscisse de la tortue]]
YCOOR=[0 [Renvoie l'ordonnée de la tortue]]